7 10
0000000000
0110110110
0110111120
0111110110
0401100310
0101110110
0000000000