10 15
000000000000000
011101111001110
011111111111110
000110110011010
020013111101010
011001111111010
001110110104010
000131110100010
011111110111140
000000000000000