15 12
000000000000
011111110110
010000011110
010211110110
010101000110
010101000110
010101110110
010131010010
010131011110
010131001010
010001001010
011111111040
010000001040
011111111040
000000000000